#########################
#....E.....1......P.....#
#.......*.########.E.#..#
#..........*.....2...#.X#
######################..#
                     ####