#########################
#....E.....1............#
#.......*....#####.E.#..#
#.P........*.....2...#.X#
######################..#
                     ####