r----l
r____l      r-----------l
r....l      r___________l
r..2-l      r....X.....Bl
r..L_l      rX2---------l
rP.--l      r.L___R-----l
r..__l      r.l   r_____l
r....ac--l  r.l   r.....l
r....bd__l  r.l   r.----l
r-4....acl  r.l   r.____l
raR--4.bdl  r.l   r.....l
rbacac...lrac.--l r---4.l
r.bdbdac.lrbd.__lrac-LR.l
r........lr.....lrbd_lr.l
r.---------.2-4.--...--.l
r._________.L_R.__.ac__.l
r....X...X..l r....X....l
r-----------l r---------l
r___________l r_________l